10
--------x-
---x----x-
---g------
-xxx-x----
-x-x------
----------
--x----x--
----------
-i-x------
----------