10
........+.
.+++++..+.
.+.g.+....
.+...+....
.+++++....
..........
..+....+..
..........
.i.+......
.........+